##..##############
##..............##
########..########
##........##....##
##..########..####
